######################
#                  e #
#o                   #
#                 e  #
# o                  #
#   i                #
#               e    #
# o                  #
#                 e  #
#o                   #
#                  e #
######################
